 mapEnemyRoute0 = new int[,] { 
        {98,98,98,98,98,98,98,98,98,98,98,98,98,98,98},
        {99,99,99,99,99,99,99,99,99,99,99,99,99,99,99},
        {99,41,40,39,38,37,36,35,34,33,32,31,30,29,99},
        {43,42,99,99,99,99,99,99,99,99,99,99,99,28,99},
        {99,99,99,98,98,98,98,98,98,98,98,98,99,27,26},
        {98,98,98,98,98,98,99,99,99,99,99,99,99,99,25},
        {98,98,98,98,98,98,99,17,18,19,20,21,22,23,24},
        {98,98,98,98,98,98,99,16,99,99,99,99,99,99,99},
        {98,98,98,98,98,98,99,15,99,98,98,98,98,98,98},
        {98,98,98,98,98,98,99,14,99,98,98,98,98,98,98},
        {98,98,98,98,98,98,99,13,99,98,98,98,98,98,98},
        {98,98,98,98,98,98,99,12,99,98,98,99,99,99,99},
        {98,98,98,98,98,98,99,11,99,99,99,99,2,1,0},
        {98,98,98,98,98,98,99,10,9,8,99,99,3,99,99},
        {98,98,98,98,98,98,99,99,99,7,6,5,4,99,98},
            };

'((Å@ÅÜÑtÅÖÅG))'

 mapTable0 = new int[,] {
       {0,0,0,0,0,0,1,0,0,0,0,0,0,0,0},
       {1,0,0,1,0,0,0,0,0,0,0,0,0,0,0},
       {1,1,1,1,1,1,1,1,1,1,1,1,1,1,0},
       {1,1,0,0,0,0,0,0,0,0,0,0,0,1,0},
       {0,0,0,0,0,0,0,1,0,0,0,0,0,1,1},
       {0,0,0,0,1,0,1,0,0,0,0,0,0,0,1},
       {0,0,1,0,1,1,0,1,1,1,1,1,1,1,1},
       {0,1,1,1,1,0,0,1,0,0,0,0,0,1,0},
       {0,1,1,1,1,0,0,1,0,0,0,0,0,1,1},
       {1,1,1,1,1,0,1,1,1,0,0,1,1,1,1},
       {1,1,1,1,1,1,1,1,1,1,1,1,1,1,1},
       {0,1,1,1,1,1,1,1,1,1,1,1,1,1,0},
       {0,0,1,1,1,1,1,1,1,0,0,0,1,1,1},
       {0,1,1,1,1,1,0,1,1,1,0,0,1,0,0},
       {0,1,1,1,1,1,1,0,0,1,1,1,1,1,1},
                                    };