    mapTable2 = new int[,] { 
       {1,1,1,1,1,1,1,1,1,1,1,1,1,1,1},
       {1,0,0,0,0,0,0,1,0,0,0,0,0,0,0},
       {1,1,1,1,1,1,1,1,1,1,1,1,1,0,0},
       {1,0,1,0,1,0,1,0,1,0,0,0,1,1,0},
       {1,0,1,0,1,0,1,0,1,0,0,0,0,1,0},
       {0,1,1,1,1,1,1,1,1,1,1,1,1,1,0},
       {0,1,0,0,0,0,0,0,0,0,0,1,0,1,0},
       {0,1,0,1,1,1,1,1,1,1,0,1,1,1,0},
       {0,1,0,1,1,1,1,1,1,1,1,0,0,0,0},
       {0,1,0,1,0,0,0,0,0,1,1,1,1,1,0},
       {0,1,0,1,1,1,1,1,0,0,1,1,1,1,0},
       {0,1,0,1,1,1,1,1,0,0,0,0,0,0,0},
       {0,1,1,1,1,0,1,0,1,1,0,0,1,0,0},
       {0,0,0,0,0,0,0,0,0,0,0,0,0,0,0},
       {1,1,1,1,1,1,1,1,1,1,1,1,1,1,1},
        };


   mapEnemyRoute2 = new int[,] { 
      {99,99,99,99,99,99,99,99,99,99,99,99,99,99,99},
      {58,99,99,99,99,99,99,99,99,99,99,99,99,99,99},
      {57,56,55,54,53,52,51,50,49,48,47,46,45,99,99},
      {99,99,99,99,99,99,99,99,99,99,99,99,44,43,99},
      {99,99,99,99,99,99,99,99,99,99,99,99,99,42,99},
      {99,25,26,27,28,29,30,31,32,33,34,35,99,41,99},
      {99,24,99,99,99,99,99,99,99,99,99,36,99,40,99},
      {99,23,99,99,99,99,99,99,99,99,99,37,38,39,99},
      {99,22,99,99,99,99,99,99,99,99,99,99,99,99,99},
      {99,21,99,99,99,99,99,99,99,99,99,99,99,99,99},
      {99,20,99,99,99,99,99,99,99,99,99,99,99,99,99}, 
      {99,19,99,99,12,11,10,99,99,99,99,99,99,99,99},
      {99,18,99,99,13,99, 9,99,99,99,99,99,99,99,99},
      {99,17,16,15,14,99, 8, 7, 6, 5, 4, 3, 2, 1, 0},
      {99,99,99,99,99,99,99,99,99,99,99,99,99,99,99},
        };
