     mapTable1 = new int[,] { 
       {1,1,1,1,1,1,1,1,1,1,1,1,1,1,1},
       {1,1,1,1,1,1,1,1,1,1,1,1,1,1,1},
       {1,1,1,1,1,1,1,1,1,1,1,1,1,1,1},
       {0,0,0,1,0,1,0,1,0,1,1,1,0,1,1},
       {1,0,0,1,1,1,0,1,0,1,1,1,0,1,1},
       {0,0,0,1,1,1,1,1,1,1,1,1,0,1,1},
       {0,1,1,1,1,1,1,1,1,1,1,1,1,1,1},
       {1,1,1,1,0,0,0,0,0,0,0,0,0,1,1},
       {1,0,0,1,0,0,0,0,0,0,1,0,0,1,1},
       {0,0,0,1,0,0,0,0,0,0,0,0,0,0,1},
       {1,0,0,1,0,0,0,1,0,0,0,0,0,0,1},
       {0,1,1,1,1,1,1,1,1,1,0,1,1,1,1},
       {1,1,1,1,1,1,1,1,1,1,0,0,1,0,0},
       {1,1,1,0,1,1,1,0,1,1,1,1,1,0,0},
       {0,1,1,1,1,1,1,1,1,1,1,1,1,0,1},
                                    };

ÅiÅ@ÅÜÑtÅÖÅGÅj

    mapEnemyRoute1 = new int[,] { 
        {99,99,99,99,99,99,99,99,99,99,99,99,99,99,99},
        {99,54,53,52,51,50,49,48,47,46,45,44,43,42,99},
        {99,99,99,99,99,99,99,99,99,99,99,99,99,41,99},
        {99,99,99,99,99,99,99,99,99,99,99,99,99,40,99},
        {99,99,99,99,99,99,99,99,99,99,99,99,99,39,99},
        {99,99,99,99,99,99,99,99,99,99,99,99,99,38,99},
        {99,99,99,26,27,29,30,31,32,33,34,35,36,37,99},
        {99,99,99,25,99,99,99,99,99,99,99,99,99,99,99},
        {99,99,99,24,99,99,99,99,99,99,99,99,99,99,99},
        {99,99,99,23,99,99,99,99,99,99,99,99,99,99,99},
        {99,99,99,22,99,99,99,99,99,99,99,99,99,99,99}, 
        {99,19,20,21,99,99,99,99,99,99,99,99, 2, 1,0},
        {99,18,99,99,99,99,99,99,99,99,99,99, 3,99,99},
        {99,17,99,99,99,99,99,99,99,99,99,99, 4,99,99},
        {99,16,15,14,13,12,11,10, 9, 8, 7, 6, 5,99,99}
        };
