//‚¤‚¿‚ã‚¤0okeru 0okenai

     mapTable6 = new int[,] { 
        {0,1,1,0,0,0,0,0,0,0,0,0,0,0,1},
        {0,0,1,0,1,0,0,0,0,1,0,1,1,1,1},
        {1,0,1,0,0,1,1,1,1,1,0,1,0,0,1},
        {0,0,1,0,0,1,0,0,1,0,0,1,0,0,0},
        {0,0,1,0,0,1,0,0,1,0,0,1,0,1,0},
        {1,0,1,0,0,1,0,1,1,0,0,1,0,0,0},
        {1,0,1,1,1,1,1,0,1,0,0,1,0,0,0},
        {0,0,0,1,0,0,0,0,1,0,0,1,0,0,1},
        {1,0,1,1,1,1,1,1,1,0,0,1,1,1,0},
        {0,0,1,0,0,0,0,0,0,0,0,0,0,1,0},
        {0,0,1,0,0,0,0,0,0,0,0,1,1,1,0},
        {1,0,1,0,0,0,0,0,0,1,0,1,0,0,0},
        {0,0,1,1,0,0,0,0,0,1,0,1,0,1,0},
        {0,0,0,1,1,1,1,1,1,1,1,1,0,0,0},
        {0,0,0,0,0,0,1,0,0,0,0,0,1,0,1},
        };


    mapEnemyRoute6 = new int[,] { 
 {99,99,75,99,99,99,99,99,99,99, 3, 2, 1, 0,99},
 {99,99,74,99,99,99,99,99,99,99, 4,99,99,99,99},
 {99,99,73,99,99,62,61,60,59,99, 5, 6, 7, 8,99},
 {99,99,72,99,99,63,99,99,58,99,99,99,99, 9,99},
 {99,99,71,99,99,64,99,99,57,99,9999,99,10,99},
 {99,99,70,99,99,65,99,99,56,99,99,99,99,11,99},
 {99,99,69,68,67,66,99,99,55,99,99,99,99,12,99},
 {99,99,99,99,99,99,99,99,54,99,16,15,14,13,99},
 {99,99,47,48,49,50,51,52,53,99,17,99,99,99,99},
 {99,99,46,99,99,99,99,99,99,99,18,19,20,21,99},
 {99,99,45,99,37,36,35,34,33,99,99,99,99,22,99},
 {99,99,44,99,38,99,99,99,32,99,99,99,99,23,99},
 {99,99,43,99,39,99,99,99,31,99,99,99,99,24,99},
 {99,99,42,41,40,99,99,99,30,29,28,27,26,25,99},
 {99,99,99,99,99,99,99,99,99,99,99,99,99,99,99},
        };