     mapTable4 = new int[,] { 
       {0,1,0,1,0,0,1,0,0,0,1,1,1,1,1},
     Å@{0,0,0,0,0,0,1,0,0,1,1,1,1,1,1},
       {0,1,1,1,1,1,1,0,0,1,0,0,1,1,1},
       {0,1,0,0,0,0,0,0,0,1,1,1,1,0,1},
       {0,1,1,1,1,1,1,1,0,0,0,1,0,1,0},
  Å@   {0,0,0,0,0,0,0,1,0,0,1,1,1,1,1},
       {1,1,0,1,0,1,0,1,0,0,0,0,0,0,0},
       {0,1,1,0,1,0,0,1,1,1,1,1,1,1,0},
       {0,1,1,1,1,0,0,0,0,0,0,0,0,1,0},
       {0,1,1,1,0,0,1,1,1,1,1,1,1,1,0},
       {0,0,0,0,0,0,1,0,0,0,0,0,0,0,0},
       {0,1,1,1,1,1,1,0,0,1,1,0,0,1,1},
       {0,1,0,0,0,0,0,0,0,1,1,0,1,1,1},
       {0,1,0,0,0,1,0,0,1,1,1,1,0,1,1},
       {0,1,0,1,0,0,0,1,1,1,0,1,1,1,1},
        };

  mapEnemyRoute4 = new int[,] { 
       {99,99,99,99,99,99,43,99,99,99,99,99,99,99,99},
       {99,99,99,99,99,99,42,99,99,99,99,99,99,99,99},
       {99,36,37,38,39,40,41,99,99,99,99,99,99,99,99},
       {99,35,99,99,99,99,99,99,99,99,99,99,99,99,99},
       {99,34,33,32,31,30,29,28,99,99,99,99,99,99,99},
       {99,99,99,99,99,99,99,27,99,99,99,99,99,99,99},
       {99,99,99,99,99,99,99,26,99,99,99,99,99,99,99},
       {99,99,99,99,99,99,99,25,24,23,22,21,20,19,99},
       {99,99,99,99,99,33,99,99,99,99,99,99,99,18,99},
       {99,99,99,99,99,99,10,11,12,13,14,15,16,17,99},
       {99,99,99,99,99,99,09,99,99,99,99,99,99,99,99},
       {99,03,04,05,06,07,08,99,99,99,99,99,99,99,99},
       {99,02,99,99,99,99,99,99,99,99,99,99,99,99,99},
       {99,01,99,99,99,99,99,99,99,99,99,99,99,99,99},
       {99, 0,99,99,99,99,99,99,99,99,99,99,99,99,99},
        };